FFFFFFFFFFFF
FTTFFFTFFTTF
FFTTTTTTTTFF
FTTFFFTFFTTF
FTFFTFTFFFFF
FTFTTTFTTTTF
FTFFFTTTFFTF
FTTTFFTFFTTF
FFFTFFFTTTFF
FFFTTTFTFTFF
FTTTFTTTFTTF
FFFFFFFFFFFF